###############
#.....#.......#
#..B..#...T...#
#.....#.......#
###.#####.#####
#.......#.....#
#...T...#..B..#
#.......#.....#
#.............#
###############
p1 1
