####################
#..................#
#..B...T...T...B...#
#..................#
###################.
#..................#
#...T...B...B...T..#
#..................#
####################
p1 1
