################
#..............#
#..B..B..T..T..#
#..............#
###.##.######.##
#..............#
#..T..T..B..B..#
#..............#
################
p1 1
