########################
#......................#
#..B...B...B...T...T...#
#......................#
#..T...................#
########################
p1 1
