#######################
#.....................#
#.B.B.B.T.T.T.........#
#.....................#
####.####.####.########
#.....................#
#.........T.T.T.B.B.B.#
#.....................#
#######################
p1 1
