##########################
#........................#
#..B...B...B...B...B.....#
#........................#
####.#####.#####.#####.###
#........................#
#..T...T...T...T...T.....#
#........................#
##########################
p1 1
