#####################
#...................#
#.B.B.B.............#
#...................#
###.###.###.###.#####
#...................#
#.............T.T.T.#
#...................#
#####################
p10 4
